9999999999999999999999999999999999999999999999999999999999999999999
9000000000000000000000000000000000000000000000000000000000000000009
9090909090909090909090909090909090909090909090909090909090909090909
9000000000000000000000000000000000000000000000000000000000000000009
9090909090909090909090909090909090909090909090909090909090909090909
9000000000000000000000000000000000000000000000000000000000000000009
9090909090909090909090909090909090909090909090909090909090909090909
9000000000000000000000000000000000000000000000000000000000000000009
9090909090909090909090909090909090909090909090909090909090909090909
9000000000000000000000000000000000000000000000000000000000000000009
9090909090909090909090909090909090909090909090909090909090909090909
9000000000000000000000000000000000000000000000000000000000000000009
9090909090909090909090909090909090909090909090909090909090909090909
9000000000000000000000000000000000000000000000000000000000000000009
9090909090909090909090909090909090909090909090909090909090909090909
9000000000000000000000000000000000000000000000000000000000000000009
9090909090909090909090909090909090909090909090909090909090909090909
9000000000000000000000000000000000000000000000000000000000000000009
9090909090909090909090909090909090909090909090909090909090909090909
9000000000000000000000000000000000000000000000000000000000000000009
9090909090909090909090909090909090909090909090909090909090909090909
9000000000000000000000000000000000000000000000000000000000000000009
9090909090909090909090909090909090909090909090909090909090909090909
9000000000000000000000000000000000000000000000000000000000000000009
9090909090909090909090909090909090909090909090909090909090909090909
9000000000000000000000000000000000000000000000000000000000000000009
9090909090909090909090909090909090909090909090909090909090909090909
9000000000000000000000000000000000000000000000000000000000000000009
9090909090909090909090909090909090909090909090909090909090909090909
9000000000000000000000000000000000000000000000000000000000000000009
9090909090909090909090909090909090909090909090909090909090909090909
9000000000000000000000000000000000000000000000000000000000000000009
9090909090909090909090909090909090909090909090909090909090909090909
9000000000000000000000000000000000000000000000000000000000000000009
9090909090909090909090909090909090909090909090909090909090909090909
9000000000000000000000000000000000000000000000000000000000000000009
9090909090909090909090909090909090909090909090909090909090909090909
9000000000000000000000000000000000000000000000000000000000000000009
9000000000000000000000000000000000000000000000000000000000000000009
9090909090909090909090909090909090909090909090909090909090909090909
9000000000000000000000000000000000000000000000000000000000000000009
9999999999999999999999999999999999999999999999999999999999999999999