9999999999999999999999999999999999
2000000900100000000000000000000002
2000000000100000000000000000000022
2111211100100000000000000000000002
2000000000100000000000000000000002
2000000000100000000000000000000002
2000111111100000000000000000000002
2000100001230000000000000000000002
2000100003210000000000011111111112
2000100000000000000000011111111112
2000100000000000000000000000000002
2000100000000000000000000000000002
2000100000000000000000000000000002
2000100000000000000000000000000002
2000100000000000000001210000000002
2000100000000000000003210000000002
2000100000000000000000000000000002
2000100000000000000000000000000002
2000100000000000000000000000000002
2000100000000000000000000000000002
2000100000000000000000000000000002
2000111111111100000000000000000002
2000000000000000000000000000000002
1111111111111111111111111111111111